1111111111111111111111111
1C01000000000000C000000C1
1000000000000000000000001
100011C0001011000000000E1
1001000101000010000000111
1001000000000010000010001
10010000C0000010000010001
1000100000000100000010001
100001C00P001000000100C01
1000000100010C00000000001
1000000010100010000000001
10000C00010000010C0000001
1111111111111111111111111